30 50

12 12 12 12 12 12 12 12 12 12 12 12 12 12 12 12 12 12 12 12 12 12 12 12 12 12 12 12 12 12 12 12 12 12 12 12 12 12 12 12 12 12 12 12 12 12 12 12 12 12 
12 11 11 11 11 11 11 11 11 11 11 11 11 11 11 11 11 11 11 11 11 11 11 11 11 11 11 11 11 11 11 11 11 11 11 11 11 11 11 11 11 11 11 11 11 11 11 11 11 12 
12 11 14 11 11 11 11 11 11 14 11 11 11 11 11 11 11 14 11 11 11 11 11 11 11 11 14 11 11 11 11 11 11 11 11 11 14 11 11 11 11 11 14 11 11 11 11 14 11 12 
12 11 11 11 6 6 6 6 6 6 6 6 6 6 6 6 6 6 6 6 6 6 6 6 6 6 6 6 6 6 6 6 6 6 6 6 6 6 6 6 6 6 6 6 6 6 11 11 11 12 
12 11 11 4 0 0 0 0 0 0 0 0 0 0 0 0 0 0 0 0 0 0 0 0 0 0 0 0 0 0 0 0 0 0 0 0 0 0 0 0 0 0 0 0 0 0 3 11 11 12 
12 11 11 4 0 0 21 21 21 21 21 21 21 21 21 21 21 21 21 21 21 21 21 21 21 21 21 21 21 21 21 21 21 21 21 21 21 21 21 21 21 21 21 21 0 0 3 11 11 12 
12 11 11 4 0 1 22 22 22 22 22 22 22 22 22 22 22 22 22 22 22 22 22 22 22 22 22 22 22 22 22 22 22 22 22 22 22 22 22 22 22 22 22 22 2 0 3 11 11 12 
12 11 11 4 0 1 2 0 0 0 0 0 0 0 0 0 0 0 0 0 0 0 0 0 0 0 0 0 0 0 0 0 0 0 0 0 0 0 0 0 0 0 0 1 2 0 3 14 11 12 
12 11 14 4 0 1 2 0 8 5 5 5 5 5 5 5 5 5 5 5 5 5 5 5 5 5 5 5 5 5 5 5 5 5 5 5 5 5 5 5 5 7 0 1 2 0 3 11 11 12 
12 11 11 4 0 1 2 0 3 11 36 37 38 11 11 11 11 11 11 11 11 11 11 11 11 11 11 11 11 11 11 11 11 11 11 11 11 27 28 29 11 4 0 1 2 0 3 11 11 12 
12 11 11 4 0 1 2 0 3 11 39 40 41 11 11 11 11 11 11 11 11 11 11 11 11 11 11 11 11 11 11 11 11 11 11 11 11 30 31 32 11 4 0 1 2 0 3 11 11 12 
12 11 11 4 0 1 2 0 3 11 42 43 44 11 11 11 11 12 12 12 12 12 12 12 12 12 12 12 12 12 12 12 12 12 11 11 11 33 34 35 11 4 0 1 2 0 3 11 11 12 
12 11 11 4 0 1 2 0 3 11 11 0 11 11 11 11 12 12 13 13 13 13 13 13 13 13 13 13 13 13 13 13 13 12 11 11 11 11 0 11 11 4 0 1 2 0 3 14 11 12 
12 11 11 4 0 1 2 0 0 0 0 0 11 11 11 12 13 13 13 13 13 13 13 13 13 13 13 13 13 13 13 13 13 12 12 12 11 11 0 0 0 0 0 1 2 0 3 11 11 12 
12 11 11 4 0 1 2 0 3 11 11 11 11 11 11 12 13 13 13 13 13 13 13 13 13 13 13 13 13 13 13 13 13 13 13 12 11 11 11 11 11 4 0 1 2 0 3 11 11 12 
12 11 14 4 0 1 2 0 3 11 11 11 11 11 11 12 13 13 13 13 13 13 13 13 13 13 13 13 13 13 13 13 13 13 13 12 11 11 11 11 11 4 0 1 2 0 3 11 11 12 
12 11 11 4 0 1 2 0 3 11 27 28 29 11 11 12 12 13 13 13 13 13 13 13 13 13 13 13 13 13 13 13 13 13 13 12 11 36 37 38 11 4 0 1 2 0 3 11 11 12 
12 11 11 4 0 1 2 0 3 11 30 31 32 11 11 11 12 13 13 13 13 13 13 13 13 13 13 13 13 13 13 13 13 12 12 12 11 39 40 41 11 4 0 1 2 0 3 11 11 12 
12 11 11 4 0 1 2 0 3 11 33 34 35 11 11 11 11 12 12 12 12 12 12 12 13 13 12 12 12 12 12 12 12 12 11 11 11 42 43 44 11 4 0 1 2 0 3 11 11 12 
12 11 11 4 0 1 2 0 3 11 11 0 11 11 11 11 11 11 11 11 11 11 11 12 12 12 12 11 11 11 11 11 11 11 11 11 11 11 0 11 11 4 0 1 2 0 3 14 11 12 
12 11 11 4 0 1 2 0 0 0 0 0 11 11 11 11 11 11 11 11 11 11 11 11 11 11 11 11 11 11 11 11 11 11 11 11 11 11 0 0 0 0 0 1 2 0 3 11 11 12 
12 11 14 4 0 1 2 0 10 6 6 6 6 6 6 6 6 6 6 6 6 6 6 6 6 6 6 6 6 6 6 6 6 6 6 6 6 6 6 6 6 9 0 1 2 0 3 11 11 12 
12 11 11 4 0 1 2 0 0 0 0 0 0 0 0 0 0 0 0 0 0 0 0 0 0 0 0 0 0 0 0 0 0 0 0 0 0 0 0 0 0 0 0 1 2 0 3 11 11 12 
12 11 11 4 0 1 2 21 21 21 21 21 21 21 21 21 21 21 21 21 21 21 21 21 21 21 21 21 21 21 21 21 21 21 21 21 21 21 21 21 21 21 21 1 2 0 3 11 11 12 
12 11 11 4 0 0 22 22 22 22 22 22 22 22 22 22 22 22 22 22 22 22 22 22 22 22 22 22 22 22 22 22 22 22 22 22 22 22 22 22 22 22 22 22 0 0 3 11 11 12 
12 11 11 4 0 0 0 0 0 0 0 0 0 0 0 0 0 0 0 0 0 0 0 0 0 0 0 0 0 0 0 0 0 0 0 0 0 0 0 0 0 0 0 0 0 0 3 11 11 12 
12 11 11 11 5 5 5 5 5 5 5 5 5 5 5 5 5 5 5 5 5 5 5 5 5 5 5 5 5 5 5 5 5 5 5 5 5 5 5 5 5 5 5 5 5 5 11 11 11 12 
12 11 14 11 11 11 11 11 11 11 14 11 11 11 11 11 11 11 11 14 11 11 11 11 11 11 11 11 14 11 11 11 11 11 11 11 11 11 11 14 11 11 11 11 11 11 11 14 11 12 
12 11 11 11 11 11 11 11 11 11 11 11 11 11 11 11 11 11 11 11 11 11 11 11 11 11 11 11 11 11 11 11 11 11 11 11 11 11 11 11 11 11 11 11 11 11 11 11 11 12 
12 12 12 12 12 12 12 12 12 12 12 12 12 12 12 12 12 12 12 12 12 12 12 12 12 12 12 12 12 12 12 12 12 12 12 12 12 12 12 12 12 12 12 12 12 12 12 12 12 12 

